Novel of size 1: +word_boundary	#
Novel of size 1: -word_boundary	B,CH,D,DH,F,G,HH,JH,K,L,M,N,NG,P,R,S,SH,T,TH,V,W,Y,Z,ZH
Novel of size 1: +spread	HH
Novel of size 1: -consonantal	R,W,Y
Novel of size 2: -continuant,+voice	B,D,G,JH
Novel of size 3: +continuant,+voice,+coronal	DH,Z,ZH
Novel of size 2: -voice,+strident	CH,S,SH
Novel of size 2: -voice,+anterior	S,T,TH
Novel of size 3: +continuant,-voice,+coronal	S,SH,TH
Novel of size 2: +voice,+anterior	D,DH,Z
Novel of size 1: -sonorant	B,CH,D,DH,F,G,HH,JH,K,P,S,SH,T,TH,V,Z,ZH
Novel of size 2: -approximant,-anterior	CH,JH,SH,ZH
Novel of size 2: +continuant,+coronal	DH,S,SH,TH,Z,ZH
Novel of size 2: +anterior,-strident	D,DH,L,N,T,TH
Novel of size 2: -sonorant,+labial	B,F,P,V
Novel of size 3: +continuant,+voice,-anterior	ZH
Novel of size 2: +continuant,+strident	S,SH,Z,ZH
Novel of size 2: -continuant,+coronal	CH,D,JH,T
Novel of size 2: -sonorant,+anterior	D,DH,S,T,TH,Z
Novel of size 3: -continuant,+voice,-anterior	JH
Novel of size 3: -continuant,+voice,+labial	B
Novel of size 3: -continuant,+voice,+anterior	D
Novel of size 3: +continuant,-voice,+labial	F
Novel of size 2: +voice,+dorsal	G
Novel of size 1: +dorsal	G,K,NG
Novel of size 2: -voice,+dorsal	K
Novel of size 1: +lateral	L
Novel of size 2: +nasal,+labial	M
Novel of size 1: +approximant	L,R,W,Y
Novel of size 2: +nasal,+coronal	N
Novel of size 1: +coronal	CH,D,DH,JH,L,N,R,S,SH,T,TH,Z,ZH
Novel of size 3: -continuant,-voice,+labial	P
Novel of size 2: +approximant,-anterior	R
Novel of size 3: -voice,+anterior,+strident	S
Novel of size 1: +nasal	M,N,NG
Novel of size 2: -continuant,-voice	CH,K,P,T
Novel of size 3: -continuant,-voice,+anterior	T
Novel of size 3: +continuant,-voice,-anterior	SH
Novel of size 3: +continuant,+voice,+labial	V
Novel of size 1: +back	W
Novel of size 1: -back	Y
Novel of size 3: +voice,+anterior,+strident	Z
Novel of size 1: -continuant	B,CH,D,G,JH,K,P,T
Novel of size 2: +continuant,+voice	DH,V,Z,ZH
Novel of size 2: +continuant,-voice	F,HH,S,SH,TH
Novel of size 2: -sonorant,+coronal	CH,D,DH,JH,S,SH,T,TH,Z,ZH
Novel of size 3: -continuant,-voice,-anterior	CH
Novel of size 2: +voice,-anterior	JH,ZH
Novel of size 1: +voice	B,D,DH,G,JH,V,Z,ZH
Novel of size 3: +continuant,-voice,-strident	TH
Novel of size 1: -approximant	B,CH,D,DH,F,G,HH,JH,K,M,N,NG,P,S,SH,T,TH,V,Z,ZH
Novel of size 1: -anterior	CH,JH,R,SH,ZH
Novel of size 2: -approximant,+labial	B,F,M,P,V
Novel of size 1: -strident	D,DH,L,N,R,T,TH
Novel of size 3: -continuant,+voice,+coronal	D,JH
Novel of size 2: +continuant,-anterior	SH,ZH
Novel of size 3: +continuant,+voice,-strident	DH
Novel of size 3: +continuant,+voice,+strident	Z,ZH
Novel of size 2: -approximant,+anterior	D,DH,N,S,T,TH,Z
Novel of size 2: +voice,+coronal	D,DH,JH,Z,ZH
Novel of size 2: -sonorant,-strident	D,DH,T,TH
Novel of size 2: -sonorant,+dorsal	G,K
Novel of size 2: -continuant,+labial	B,P
Novel of size 2: -voice,+labial	F,P
Novel of size 2: -continuant,+anterior	D,T
Novel of size 2: +voice,+labial	B,V
Novel of size 2: +sonorant,+anterior	L,N
Novel of size 2: +continuant,+labial	F,V
Novel of size 2: +approximant,+coronal	L,R
Novel of size 2: +sonorant,+consonantal	L,M,N,NG
Novel of size 1: +sonorant	L,M,N,NG,R,W,Y
Novel of size 2: -continuant,-anterior	CH,JH
Novel of size 2: +sonorant,+labial	M,W
Novel of size 2: +continuant,+anterior	DH,S,TH,Z
Novel of size 3: +continuant,-voice,+strident	S,SH
Novel of size 2: +anterior,+strident	S,Z
Novel of size 1: +high	W,Y
Novel of size 2: -approximant,+coronal	CH,D,DH,JH,N,S,SH,T,TH,Z,ZH
Novel of size 1: -voice	CH,F,HH,K,P,S,SH,T,TH
Novel of size 2: +sonorant,+dorsal	NG
Novel of size 3: -continuant,-voice,+coronal	CH,T
Novel of size 2: -voice,-anterior	CH,SH
Novel of size 1: +consonantal	B,CH,D,DH,F,G,HH,JH,K,L,M,N,NG,P,S,SH,T,TH,V,Z,ZH
Novel of size 1: +continuant	DH,F,HH,S,SH,TH,V,Z,ZH
Novel of size 2: +voice,+strident	JH,Z,ZH
Novel of size 3: +continuant,-voice,+anterior	S,TH
Novel of size 2: +voice,-strident	D,DH
Novel of size 2: -voice,-strident	T,TH
Novel of size 1: +labial	B,F,M,P,V,W
Novel of size 1: +strident	CH,JH,S,SH,Z,ZH
Novel of size 2: -voice,+coronal	CH,S,SH,T,TH
Novel of size 1: +anterior	D,DH,L,N,S,T,TH,Z
Novel of size 2: -approximant,-strident	D,DH,N,T,TH
Novel of size 3: +continuant,+voice,+anterior	DH,Z
Novel of size 2: +sonorant,+coronal	L,N,R
Novel of size 2: +continuant,-strident	DH,TH
Novel of size 2: +coronal,+consonantal	CH,D,DH,JH,L,N,S,SH,T,TH,Z,ZH
